################
#..S.......S...#
#..............#
#..C.........C.#
#......DD......#
#..S.........S.#
#......DD......#
#..C.........C.#
#..............#
#..S.......S...#
################
