####################
#..S.....#....S....#
#........#.........#
#...C....#....C....#
#........D.........#
#....#####.#####...#
#...........#......#
#..S........#...S..#
#...........#......#
#...#####.#####....#
#.........D........#
#....C....#....C...#
#.........#........#
#..S......#.....S..#
####################
